# EmblemForge 地图数据文件
# TileType: 0=障碍物, 1=可行走, 2=回血(一次)
# 行 = Y 轴（从上到下），列 = X 轴
0,0,0,0,0,0,0,0,0
0,1,1,1,1,1,1,1,0
0,1,2,1,1,1,2,1,0
0,1,1,1,0,1,1,1,0
0,1,1,1,0,1,1,1,0
0,1,2,1,1,1,2,1,0
0,1,1,1,1,1,1,1,0
0,0,0,0,0,0,0,0,0
